DLDLDLDLDLDLDLDLDLDL
LDLDLDLDLDLDLDLDLDLD
DLDLDLDLDLDLDLDLDLDL
LDLDLDLDLDLDLDLDLDLD
DLDLDLD    LDLDLDLDL
LDLDLDLDLDLDLDLDLDLD
DLDLDLDLDLDLDLDLDLDL
LDLDLDLDLDLDLDLDLDLD
DLDLDLDLDLDLDLDLDLDL
LDLDLDLDLDLDLDLDLDLD
DLDLDLDLDLDLDLDLDLDL
LDLDLDLDLDLDLDLDLDLD
DLDLDLDLDLDLDLDLDLDL
LDLDLDLDLDLDLDLDLDLD
DLDLDLDLDLDLDLDLDLDL
LDLDLDLDLDLDLDLDLDLD
DLDLDLDLDLDLDLDLDLDL
LDLDLDLDLDLDLDLDLDLD
DLDLDLDLDLDLDLDLDLDL
LDLDLDLDLDLDLDLDLDLD
